1111111111111111
100000C00C0000C1
10Z00MC000ECMMC1
10101C1MM0C0MMM1
10P10C0CC00M0111
1111111111111111
