111111111111111
10000CMMCCC0001
1CCCCM000CCM001
100000000000Z01
100P00000111101
1E0000000000001
111111111111111