1111111111111111111111111
1E000000000000C000C000001
1010010100100000001111111
10100100101010100C1000001
10P000000C00C000001111111
1111111111111111111111111
