1111111111111111111111111
100000PEC0000C0C111111111
1000000000000000000000001
1111111111111111111111111
