11111111111111111
10EE00PEC0000C0C1
11111111111111111