1111111111111111111111111111111
1000000000000000000001111111111
1111111111111111111111111111111
1111111111111111111111111111111
1111111111111111111111111111111
1111111111111111111111111111111

