1111111111111111111111111
10000000000000C000C000001
100E010100100M00001111111
10100100101010100C1000001
10P00M000C00C000M01111111
1111111111111111111111111
