111111111111111111111
10000CCCCCC000CCCCCC1
1CCCCC000CCC00CCCCCC1
10000000000000CCC11C1
100P0000011110111CC11
1E000000000000CCCCCC1
111111111111111111111