1111111111111111
100000C00C0000C1
100E00MCZ00CMMC1
10101C1MM0C0MMM1
10P10C0CCE0M0111
1111111111111111