1111111111111111111111111
1E000000000000C000C000001
1010010100100000101010101
1010010010101010001010101
1P0C00000C00C0000000000C1
1111111111111111111111111
