1111111111111111
100000C00C000001
100E00M0Z0111111
101010100C000001
10P00M0CCE0M0111
1111111111111111